femaleFirst	maleFirst	femaleSecond	maleSecond
Nafisa	Harold	Gimik	Gimik
Alysa	Orion	Burlu	Burlu
Yvonne	Jacob	Zijat	Zijat
Zada	Reuben	Gary	Gary
Dabria	Jake	Flugil	Flugil
Emily	Whitby	Amik	Amik
Helena	Max	David	David
Abigail	Mike	James	James
Vala	Fuller	Percy	Percy
Shams	Lloyd	Horbek	Horbek
Zahara	Vail	Kirk	Kirk
Crystal	Ted	Ivens	Ivens
Gwen	Vincent	Ehhum	Ehhum
Nicole	Joshua	Rafnil	Rafnil
Harriet	Koen	Pulver	Pulver
Belle	Isa	Stelum	Stelum
Fiona	Emil	Kuvan	Kuvan
Lewa	Sanders	Marum	Marum
Kiran	Chale	Chener	Chener
Wilma	Oringo	Marban	Marban
Dora	Curtis	Klub	Klub
Isoke	Jamison	Quick	Quick
Valora	Dennis	Kamino	Kamino
Floria	Cavan	Haska	Haska
Laila	Enrico	Kuirej	Kuirej
Nadia	Fidel	Paner	Paner
Ora	Erik	Hill	Hill
Idonia	Jeffrey	Korjas	Korjas
Zinia	Hilton	Ostum	Ostum
Claire	Frasier	Domet	Domet
Vanna	Tymon	Keith	Keith
Oralie	Kontar	Hakil	Hakil
Diana	Oakley	Chipen	Chipen
Carly	Kevin	Montum	Montum
Brenda	Norman	Clark	Clark
Kohana	Hank	Sabler	Sabler
Stella	Khalil	Bird	Bird
Trixie	Tilden	Clive	Clive
Dara	Palma	Gust	Gust
Julia	Justin	Plumuj	Plumuj
Vida	Lian	Butik	Butik
Lara	Nate	Hark	Hark
Nina	Lang	Pomuj	Pomuj
Eleanor	Lucas	Hall	Hall
Noya	Edison	Bondno	Bondno
Rayna	Oscar	Lewis	Lewis
Fern	Eugene	Piruj	Piruj
Bianca	Walker	Heldan	Heldan
Fleur	Dave	Ameblo	Ameblo
Anna	Hollis	Bravul	Bravul
Laura	Orsen	Cook	Cook
Ella	Samuel	Traman	Traman
Pamela	Oren	Nomum	Nomum
Uma	Colin	Saist	Saist
Bree	Trevor	Famili	Famili
Roxana	Ovid	Verum	Verum
Halona	Elmo	Karlan	Karlan
Maren	Angelo	Inkuj	Inkuj
Elita	Fisk	Vishon	Vishon
Cybill	Enos	Rose	Rose
Bonnie	Magnus	Land	Land
Irisa	Platon	Pilk	Pilk
Eranthe	Kester	Pepian	Pepian
Daisy	Adley	Tipum	Tipum
Harmony	Harlan	Skatol	Skatol
Aggie	Ranen	Fiskan	Fiskan
Haile	Xerxes	Scott	Scott
Debbie	York	Aerum	Aerum
Gloria	Milo	Urbum	Urbum
Zoe	Dustin	Smith	Smith
Gitana	Slade	Owen	Owen
Ivy	Nika	Homar	Homar
Linda	Ibrahim	Regum	Regum
Gelsey	Jim	Kodlar	Kodlar
Cady	Kelvin	Ralfan	Ralfan
Tama	Ian	Vort	Vort
Isis	Santos	Kruf	Kruf
Zina	Isaiah	Joyce	Joyce
Kate	Floyd	Bell	Bell
Olivia	Kenelm	Celum	Celum
Irene	Sam	Cecil	Cecil
Lilac	Octavio	Richul	Richul
Ula	Vernon	Arbar	Arbar
Hea	Lisle	Jagu	Jagu
Shanon	Whitley	Kvarop	Kvarop
Vicki	Marc	Shuist	Shuist
Kande	Hadley	Sagum	Sagum
Zarah	Elgin	Kradan	Kradan
Ruth	Ervin	Baker	Baker
Judy	Rich	Emilan	Emilan
Tanya	Tino	Herb	Herb
Tawnie	Ethan	Irlan	Irlan
Zeva	Issay	Kunul	Kunul
Helen	Bobby	Libret	Libret
Emma	Irving	Green	Green
Tertia	Gabe	Adams	Adams
Tina	Jason	Devum	Devum
Efia	David		
Abbie	Freddy		
Linnea	Bruno		
Rabia	Riane		
Sylvia	Aidan		
Zsuzsa	William		
Dorothy	Marco		
Rose	Jarvis		
Blossom	Gibson		
Lark	Salman		
Bena	Habib		
Peggy	Paddy		
Summer	Stephen		
Lana	Paris		
Rae	Dan		
Lecea	Adan		
Cain	Darren		
Abina	Edward		
Ailis	Eddy		
Nancy	Alfred		
Florida	Kenyon		
Tulla	Yale		
Paloma	Karl		
Sabah	Brooks		
Rhoda	Xanthus		
Gaia	Raymon		
Aine	Ken		
Gamila	Noah		
Autumn	Elliot		
Xena	Uri		
Odessa	Tyson		
Thirza	Pasi		
Vera	Leonard		
Noella	Nalu		
Shela	Timothy		
Malak	Darin		
Karima	Ingmar		
Ummi	Fritz		
Zole	Kent		
Dianne	Wilson		
Tamara	Larry		
Orenda	Lewis		
Isleta	Hans		
Laurie	Allen		
Ros	Gerald		
Agatha	Kenton		
Winema	Maurice		
Edana	Ruben		
Urania	Livvy		
Freya	Zion		
Thea	Quillan		
Ebony	Waldo		
Tania	Gavin		
Kefira	Herman		
Edda	Clement		
Gella	Clinton		
Felcia	Finley		
Dagny	Smith		
Willow	Porter		
Farrah	Parker		
Fawn	Tracis		
Dulcea	Keith		
Neysa	Daren		
Acacia	Richard		
Cynthia	Ernest		
Manda	Vinnie		
Diane	Truman		
Olinda	Ahren		
Vevina	Yancy		
Irina	Anthony		
Gita	Angus		
Hasana	Gordon		
Liana	Carlos		
Faith	Duncan		
Kanya	Adam		
Dawn	Roger		
Talia	Madison		
Olathe	Marcel		
Malina	Barth		
Halima	Pablo		
Dior	Kellen		
Oceana	Edwin		
Phoebe	Baldwin		
Aba	Barney		
Bambi	Holden		
Ipo	Dalton		
Isabel	Merlin		
Georgia	Willie		
Endora	Romeo		
Alicia	Kermit		
Camille	Cyrus		
Ady 	Jarek		
Vicky	Conrad		
Grace	Nigel		
Lena	Fabian		
Ilona	Willis		
Heidi	Obert		
Caitin	Thierry		
Hope	Nick		
Ianthe	Reynard		
Torie	Steve		
Obelia	Alan		
Hazel	Wilfred		
Hanna	Faris		
Gail	Mark		
Olinda	Sabri		
Gytha	Orlando		
Badia	Gideon		
Feronia	Devlin		
Elaine	Yasir		
Adonia	Bali		
Bunny	Wiley		
Jewel	Rider		
Zea	Malcolm		
Oriole	Penn		
Danica	Derek		
Eva	Marlon		
Hayley	Elden		
Raissa	Ilias		
Pythia	Brian		
Posy	Polo		
Kara	Garrick		
Aure	Finn		
Nora	Galeno		
Vesta	Fergus		
Bella	Jaafar		
Serena	Warner		
Zuza	Wayne		
Connie	Urban		
Cindy	Barrett		
Jcinta	Caesar		
Shaine	Eric		
Eliza	Evan		
Maeve	Ennis		
Trina	Parry		
Honey	Itzak		
Iria	Dick		
Lala	Nolan		
Githa	Ihsan		
Adelle	Hardy		
Xandy	Lamont		
Elsa	John		
Durriya	Ormand		
Kitty	Jimmy		
Petra	Galen		
Yelena	Trey		
Doria	Ivar		
Kelli	Pascal		
Doris	Paulo		
Novia	Neil		
Neva	Yaro		
Paula	Fred		
Hana	Ward		
Chipo	Kai		
Maha	Adolph		
Alanni	Iman		
Delicia	Zach		
Jayne	Harry		
Vanora	Brand		
Jill	Tony		
Jade	Byron		
Elina	Alban		
Neoma	Nabil		
Ona	Dixon		
Karli	Brady		
Zene	Hassan		
Nabila	Felix		
Keelia	Jack		
Winona	Benson		
Lacie	Uba		
Ramya	Howard		
Rachel	Levi		
Kita	Abel		
Psyche	Saxon		
Ada 	Oliver		
Olive	Lou		
Jelena	Rock		
Yonina	Carson		
Ava	Asher		
Bonita	Bill		
Hester	Zaki		
Echo	Niel		
Canace	Albert		
Meta	Crispin		
Tia	Bob		
Julie	Qasim		
Naomi	Henry		
Azura	James		
Serwa	Winston		
Adeline	Royce		
Miette	Neal		
Daphne	Seth		
Qamar	Kern		
Kiona	Bradley		
Coral	Clavin		
Flavia	Pierre		
Joy	Elvin		
Fawziya	Ismail		
Maha	Ade		
Rowena	Olin		
Oprah	Qays		
Angie	Parson		
Elana	Luke		
Kersen	Kiros		
Ivie	Miles		
Peony	Iain		
Rosine	Iggy		
Viveka	Barclay		
Xanthe	Jesus		
Frieda	Clark		
Zora	Lucius		
Velika	Cari		
Gilana	Glenn		
Oriel	Thanos		
Odele	Ronald		
Wilona	Davin		
Gretel	Harper		
Lassie	Harman		
Leona	Burton		
Ziva	Jeff		
Hadara	Bowen		
Amber 	Buddy		
Damara	London		
Kalika	Rodman		
Sophia	Patrick		
Freda	Thomas		
Ida	Lyndon		
Penny	Oran		
Thalia	Norton		
Janna	Kalman		
Violet	Nathan		
Eirene	Stuart		
Hedva	Roy		
Nissa	Phillip		
Carol	Hale		
Chynna	Maarten		
Sela	Orville		
Selena	Salah		
Nimat	Walid		
Riva	Tobey		
Lani	Nevin		
Xenia	Leon		
Anne	Ben		
Kathy	Roman		
Rohana	Daniel		
Tyne	Tim		
Jamina	Paul		
Iris	Nelson		
Galina	Yule		
Galatea	Robert		
Thadea	Erek		
Yasmin	Fremont		
Esta	Simon		
Wenda	George		
Carmen	Simba		
Bertha	Quincy		
Rena	Gamal		
Dianthe	Frank		
Antonia	Zane		
Celeste	Walden		
Glenna	Emanuel		
Phedra	Ozzie		
Zandra	Elkan		
Sachi	Oakes		
Nona	Israel		
Sahar	Danny		
Zula	Grady		
Mora	Dirk		
Jane	Donal		
Pearl	Jasper		
Dreama	Heath		
Wanda	Chen		
Tesia	Franz		
Tricia	Jerry		
Mercia	Iggi		
Nova	Ike		
Dolly	Prince		
Bea	Conan		
Wendy	Scott		
Sally	Owen		
Raizel	Hamdi		
Ann	Galvin		
Rhea	Forrest		
Rasine	Luce		
Miki	Riordon		
Adalia	Armand		
Olga	Peter		
Nysa	Alvin		
Muriel	Beck		
Qoqa	Odon		
Delfina	Andy		
Caltha	Lance		
Genet	Isaac		
Judith	Gage		
Akili	Hackett		
Kenda	Hector		
Levana	Grant		
Oria	August		
Agnes	Joseph		
Erin	Othello		
Xylona	Ulric		
Nita	Andrew		
Madge	Kenny		
Tani	Ivan		
Jenny	Morris		
Quinta	Noel		
Eilene	Walter		
Beth	Cornell		
Opal	Kennard		
Haidee	Tomas		
Ursula	Foster		
Iola	Ingram		
Lida	Regan		
Ester	Neely		
May	Nasir		
Aurora	Kiefer		
Ines	Victor		
Mathea	Ishmael		
Netany	Samson		
Onida	Lexi		
Chloe	Emmanel		
Cerelia	Palmer		
Maleah	Billy		
Bliss	Webster		
Iona	Cain		
Alice	Bryant		
Flower	Dante		
Fronde	Anders		
Phemia	Graham		
Glory	Maxime		
Hoshi	Ivo		
Peren	Joe		
Edie	Bert		
Viola	Perry		
Ginger	Nils		
Sue	Freeman		
Irma	Yannis		
Jenna	Xavier		
Cherise	Wesley		
Fidelia	Roland		
Faye	Carter		
Nyako	Zalman		
Ingrid	Yehudi		
Ophira	Orson		
Habiba	Davis		
Odetta	Marvin		
Kirima	Nessan		
Ethel	Leroy		
Leonie	Lamar		
	Aaron		
	Jedrek		
	Hamlet		
	Rudolph		
	Rex		
